
###########
##.H.######
##...#...##
#.%%.....##
#..%%.#++##
#.....#++##
###########