###########
####.H..###
####+##..##
###.++%..##
###.%#%..##
###....####
###########